Keywords	KeywordsCorrected	Acronyms
(BLACK) DYES	DYE	DYE
??PAD	PAD	PAD
?ä-KENDALL RANK CORRELATION COEFFICIENTS	KENDALL RANK CORRELATION COEFFICIENTS	KENDALL RANK CORRELATION COEFFICIENTS
"\5.4\"" HAND GUN"""	\5.4\ HAND GUN	\5.4\ HAND GUN
"2 ,4-DINITROTOLUENE"	"2,4 DINITROTOLUENE"	"2,4 DINITROTOLUENE"
"2,4-DINITROTOLUENE"	"2,4 DINITROTOLUENE"	"2,4 DINITROTOLUENE"
AAS	ATOMIC ABSORPTION SPECTROSCOPY (AAS)	(AAS)
ACRYLIC FIBER	ACRYLIC	ACRYLIC
ACRYLIC FIBERS	ACRYLIC	ACRYLIC
ACRYLIC POLYMERS	ACRYLIC	ACRYLIC
ACRYLICS	ACRYLIC	ACRYLIC
ADHESIVE LIFTS	ADHESIVE LIFTER	ADHESIVE LIFTER
AEROSOLS	AEROSOL	AEROSOL
AIRBAGS	AIRBAG	AIRBAG
AIRBORNE PARTICLES	AIRBORNE PARTICLE	AIRBORNE PARTICLE
ALGORITHMS	ALGORITHM	ALGORITHM
ALIZARIN RED S	ALIZARIN RED S (ARS)	ALIZARIN RED S (ARS)
ALKALOIDS	ALKALOID	ALKALOID
ALLOYS	ALLOY	ALLOY
ALUMINUM	ALUMINIUM (AL)	ALUMINIUM (AL)
AMMUNITIONS	AMMUNITION	AMMUNITION
ANIMALS	ANIMAL	ANIMAL
ANIONS	ANION	ANION
ANTIMONY	ANTIMONY (SB)	ANTIMONY (SB)
ANTIMONY 121	ANTIMONY (SB)	ANTIMONY (SB)
ARTIFACTS	ARTIFACT	ARTIFACT
ATOM-ABSORPTIONS-SPEKTROPHOTOMETRIE	ATOMIC ABSORPTION SPECTROSCOPY (AAS)	(AAS)
ATOMIC ABSORPTION SPECTROMETRY	ATOMIC ABSORPTION SPECTROSCOPY (AAS)	(AAS)
ATOMIC ABSORPTION SPECTROMETRY (AAS)	ATOMIC ABSORPTION SPECTROSCOPY (AAS)	(AAS)
ATOMIC ABSORPTION SPECTROPHOTOMETRY	ATOMIC ABSORPTION SPECTROSCOPY (AAS)	(AAS)
ATOMIC ABSORPTION SPECTROSCOPY	ATOMIC ABSORPTION SPECTROSCOPY (AAS)	(AAS)
ATOMIC EMISSION SPECTROMETRY	ATOMIC ABSORPTION SPECTROSCOPY (AAS)	(AAS)
ATOMIC EMISSION SPECTROSCOPY	ATOMIC ABSORPTION SPECTROSCOPY (AAS)	(AAS)
BACK SCATTERED ELECTRON (BSE) SIGNAL	BACKSCATTERED ELECTRON DETECTOR	BACKSCATTERED ELECTRON DETECTOR
BACK SPATTER	BACKSCATTER	BACKSCATTER
BACKSCATTER ELECTRON DETECTOR SYSTEM	BACKSCATTERED ELECTRON DETECTOR	BACKSCATTERED ELECTRON DETECTOR
BACK-SCATTERED	BACKSCATTER	BACKSCATTER
BACKSPATTER	BACKSCATTER	BACKSCATTER
BALLISTICS	BALLISTIC	BALLISTIC
BARIUM	BARIUM (BA)	BARIUM (BA)
BARIUM 137	BARIUM (BA)	BARIUM (BA)
BAYES THEOREM	BAYESIAN APPROACH	BAYESIAN APPROACH
BAYES' THEOREM	BAYESIAN APPROACH	BAYESIAN APPROACH
BAYES' THEOREM	BAYES THEOREM	BAYES THEOREM
BAYESIAN	BAYESIAN APPROACH	BAYESIAN APPROACH
BAYESIAN INTERPRETATION	BAYESIAN APPROACH	BAYESIAN APPROACH
BIRDS	BIRD	BIRD
BISMUTH	BISMUTH (BI)	BISMUTH (BI)
BLACK COTTON	COTTON	COTTON
BLUE COTTON	COTTON	COTTON
BLUE WOOL FIBRES	WOOL	WOOL
BODY FLUIDS	BODY FLUID	BODY FLUID
BRAKE PADS	BRAKE PAD	BRAKE PAD
BULLET HOLE	BULLET HOLES	BULLET HOLES
BURNS	BURN	BURN
CAMERAS	CAMERA	CAMERA
CAPILLARY ELECTROPHORESIS	CAPILLARY ELECTROPHORESIS (CE)	CAPILLARY ELECTROPHORESIS (CE)
CAPILLARY MICROEXTRACTION OF VOLATILE	CAPILLARY MICROEXTRACTION OF VOLATILES (CMV)	(CMV)
CAPILLARY MICROEXTRACTION OF VOLATILES	CAPILLARY MICROEXTRACTION OF VOLATILES (CMV)	(CMV)
CAR SEATS	CAR SEAT	CAR SEAT
CARBANILIDES	CARBANILIDE	CARBANILIDE
CARTRIDGE CASING	CARTRIDGE CASE	CARTRIDGE CASE
CARTRIDGE DISCHARGE RESIDUE	CARTRIDGE DISCHARGE RESIDUES (CDR)	(CDR)
CHEMICAL COMPOSITIONS	CHEMICAL COMPOSITION	CHEMICAL COMPOSITION
CHEMICAL COMPOUNDS	CHEMICAL COMPOUND	CHEMICAL COMPOUND
CHEMICAL IMAGES	CHEMICAL IMAGE	CHEMICAL IMAGE
CHEMICAL WARFARE AGENT	CHEMICAL WARFARE AGENTS (CWAS)	CHEMICAL WARFARE AGENTS (CWAS)
CHEMICAL WARFARE AGENTS	CHEMICAL WARFARE AGENTS (CWAS)	CHEMICAL WARFARE AGENTS (CWAS)
CHEMOMETRIC	CHEMOMETRICS	CHEMOMETRICS
CHEMOMETRY	CHEMOMETRICS	CHEMOMETRICS
"CHROMATOGRAPHY, GAS"	GAS CHROMATOGRAPHY (GC)	GAS CHROMATOGRAPHY (GC)
"CHROMATOGRAPHY, HIGH PRESSURE LIQUID"	HIGH-PERFORMANCE LIQUID CHROMATOGRAPHY (HPLC)	(HPLC)
"CHROMATOGRAPHY, HIGH PRESSURE LIQUID"	HIGH PRESSURE LIQUID CHROMATOGRAPHY (HPLC)	(HPLC)
"CHROMATOGRAPHY, ION EXCHANGE"	ION EXCHANGE CHROMATOGRAPHY	ION EXCHANGE CHROMATOGRAPHY
"CHROMATOGRAPHY, LIQUID"	LIQUID CHROMATOGRAPHY (LC)	LIQUID CHROMATOGRAPHY (LC)
"CHROMATOGRAPHY, MICELLAR ELECTROKINETIC CAPILLARY"	MICELLAR ELECTROKINETIC CAPILLARY CHROMATOGRAPHY	MICELLAR ELECTROKINETIC CAPILLARY CHROMATOGRAPHY
"CHROMATOGRAPHY, THIN LAYER"	THIN LAYER CHROMATOGRAPHY (TLC)	THIN LAYER CHROMATOGRAPHY (TLC)
"CHROMATOGRAPHY, THIN LAYER"	THIN-LAYER CHROMATOGRAPHY (TLC)	THIN-LAYER CHROMATOGRAPHY (TLC)
CLOTHES	CLOTHING	CLOTHING
CLOTHING-FABRIC	CLOTHING	CLOTHING
COLOR	COLOUR	COLOUR
CONCENTRATION (PARAMETERS)	CONCENTRATION (PARAMETER)	CONCENTRATION (PARAMETER)
CONFOCAL RAMAN MICROSPECTROSCOPY	RAMAN	RAMAN
COORDINATION COMPOUNDS	COORDINATION COMPOUND	COORDINATION COMPOUND
COPPER	COPPER (CU)	COPPER (CU)
COTTON FIBERS	COTTON	COTTON
COTTON FIBRE	COTTON	COTTON
COTTON FIBRES	COTTON	COTTON
COTTONS	COTTON	COTTON
CRIME SCENE INVESTIGATIONS	CRIME SCENE INVESTIGATION	CRIME SCENE INVESTIGATION
CRIMINALISTICS	CRIMINALISTIC	CRIMINALISTIC
CYANOACRYLATES	CYANOACRYLATE	CYANOACRYLATE
CYCLIC VOLTAMMETRIC	CYCLIC VOLTAMMETRY	CYCLIC VOLTAMMETRY
CYCLIC VOLTAMMOGRAMS	CYCLIC VOLTAMMETRY	CYCLIC VOLTAMMETRY
DATA BASE	DATABASE	DATABASE
DATA SETS	DATA SET	DATA SET
DATABASES	DATABASE	DATABASE
"DATABASES, FACTUAL"	DATABASE	DATABASE
DESI MASS SPECTROMETRY	DESORPTION ELECTROSPRAY IONISATION-MASS SPECTROMETRY-MASS SPECTROMETRY (DESI-MSMS)	(DESI-MSMS)
DESI-MSMS	DESORPTION ELECTROSPRAY IONISATION-MASS SPECTROMETRY (DESI-MS)	(DESI-MS)
DESORPTION ELECTROSPRAY IONISATION MASS SPECTROMETRY	DESORPTION ELECTROSPRAY IONISATION-MASS SPECTROMETRY (DESI-MS)	(DESI-MS)
DESORPTION ELECTROSPRAY IONISATION MASS SPECTROMETRY (DESI-MS)	DESORPTION ELECTROSPRAY IONISATION-MASS SPECTROMETRY (DESI-MS)	(DESI-MS)
DESORPTION ELECTROSPRAY IONIZATION MASS SPECTROMETRY	DESORPTION ELECTROSPRAY IONISATION-MASS SPECTROMETRY (DESI-MS)	(DESI-MS)
DEVICES	DEVICE	DEVICE
DICARBOXYLIC ACIDS	DICARBOXYLIC ACID	DICARBOXYLIC ACID
DIP PEN LITHOGRAPHY	DIP-PEN LITHOGRAPHY	DIP-PEN LITHOGRAPHY
DIPHENYLAMINE	DIPHENLYAMINE (DPA)	DIPHENLYAMINE (DPA)
DISTANCE ESTIMATION	DISTANCE DETERMINATION	DISTANCE DETERMINATION
DISTANCE-BASED ??PAD	DISTANCE-BASED PAD	DISTANCE-BASED PAD
DRUGS	DRUG	DRUG
DYES	DYE	DYE
DYES (BASIC)	DYE	DYE
EAGLES	EAGLE	EAGLE
EDX	ENERGY DISPERSIVE SPECTROSCOPY (EDS)	(EDS)
EGGS	EGG	EGG
ELECTRODES	ELECTRODE	ELECTRODE
ELECTRON DISPERSIVE SPECTROMETRY	ENERGY DISPERSIVE SPECTROSCOPY (EDS)	(EDS)
ELECTRON DISPERSIVE X-RAY MICROANALYSIS	ENERGY DISPERSIVE X-RAY MICROANALYSIS	ENERGY DISPERSIVE X-RAY MICROANALYSIS
ELECTRON MICROSCOPE	ELECTRON MICROSCOPY	ELECTRON MICROSCOPY
ELECTRON MICROSCOPES	ELECTRON MICROSCOPY	ELECTRON MICROSCOPY
ELECTRONIC TONGUES	ELECTRONIC TONGUE	ELECTRONIC TONGUE
"ELECTROPHORESIS, CAPILLARY"	CAPILLARY ELECTROPHORESIS	CAPILLARY ELECTROPHORESIS
ELEMENTAL COMPOSITIONS	ELEMENTAL COMPOSITION	ELEMENTAL COMPOSITION
EMISSION SPECTROMETRY	EMISSION SPECTROSCOPY	EMISSION SPECTROSCOPY
ENERGY DISPERSIVE ANALYSIS	ENERGY DISPERSIVE SPECTROSCOPY (EDS)	(EDS)
ENERGY DISPERSIVE SPECTROMETRY	ENERGY DISPERSIVE SPECTROSCOPY (EDS)	(EDS)
ENERGY DISPERSIVE SPECTROSCOPY	ENERGY DISPERSIVE SPECTROSCOPY (EDS)	(EDS)
ENERGY DISPERSIVE X RAY ANALYSIS	ENERGY DISPERSIVE SPECTROSCOPY (EDS)	(EDS)
ENERGY DISPERSIVE X- RAY ANALYSIS (EDX)	ENERGY DISPERSIVE SPECTROSCOPY (EDS)	(EDS)
ENERGY DISPERSIVE X RAY MICROANALYSIS	ENERGY DISPERSIVE X-RAY MICROANALYSIS	ENERGY DISPERSIVE X-RAY MICROANALYSIS
ENERGY DISPERSIVE X RAY SPECTROMETER	ENERGY DISPERSIVE SPECTROSCOPY (EDS)	(EDS)
ENERGY DISPERSIVE X RAY SPECTROMETERY	ENERGY DISPERSIVE SPECTROSCOPY (EDS)	(EDS)
ENERGY DISPERSIVE X RAY SPECTROMETRY	ENERGY DISPERSIVE SPECTROSCOPY (EDS)	(EDS)
ENERGY DISPERSIVE X RAY SPECTROSCOPY	ENERGY DISPERSIVE SPECTROSCOPY (EDS)	(EDS)
ENERGY DISPERSIVE X-RAY	ENERGY DISPERSIVE SPECTROSCOPY (EDS)	(EDS)
ENERGY DISPERSIVE X-RAY ANALYSIS	ENERGY DISPERSIVE SPECTROSCOPY (EDS)	(EDS)
ENERGY DISPERSIVE X-RAY ANALYSIS (EDX)	ENERGY DISPERSIVE SPECTROSCOPY (EDS)	(EDS)
ENERGY DISPERSIVE X-RAY FLUORESCENCE	X-RAY ENERGY DISPERSIVE FLUORESCENCE	X-RAY ENERGY DISPERSIVE FLUORESCENCE
ENERGY DISPERSIVE X-RAY FLUORESCENCE SPECTROMETRY	X-RAY ENERGY DISPERSIVEFLUORESCENCE SPECTROMETRY	X-RAY ENERGY DISPERSIVEFLUORESCENCE SPECTROMETRY
ENERGY DISPERSIVE X-RAY SPECTROMETER (EDS)	ENERGY DISPERSIVE SPECTROSCOPY (EDS)	(EDS)
ENERGY DISPERSIVE X-RAY SPECTROMETRY	ENERGY DISPERSIVE SPECTROSCOPY (EDS)	(EDS)
ENERGY DISPERSIVE X-RAY SPECTROSCOPY	ENERGY DISPERSIVE SPECTROSCOPY (EDS)	(EDS)
ENERGY DISPERSIVE X-RAY SPECTROSCOPY (EDS)	ENERGY DISPERSIVE SPECTROSCOPY (EDS)	(EDS)
ENERGY-DISPERSIVE X-RAY ANALYSIS	ENERGY DISPERSIVE SPECTROSCOPY (EDS)	(EDS)
ENFSI	EUROPEAN NETWORK OF FORENSIC SCIENCE INSTITUTES	EUROPEAN NETWORK OF FORENSIC SCIENCE INSTITUTES
ETHYL CENTRALITE	ETHYL CENTRALITE (EC)	ETHYL CENTRALITE (EC)
ETHYLCENTRALITE	ETHYL CENTRALITE (EC)	ETHYL CENTRALITE (EC)
EUROPEAN NETWORK OF FORENSIC SCIENCE INSTITUTE	EUROPEAN NETWORK OF FORENSIC SCIENCE INSTITUTES	EUROPEAN NETWORK OF FORENSIC SCIENCE INSTITUTES
EXIT WOUNDS	EXIT WOUND	EXIT WOUND
FDR	FIREARM DISCHARGE RESIDUE (FDR)	FIREARM DISCHARGE RESIDUE (FDR)
FIBER	FIBRE	FIBRE
FIBER ANALYSIS	FIBRE ANALYSIS	FIBRE ANALYSIS
FIBER ANALYSIS TECHNIQUES	FIBRE ANALYSIS TECHNIQUES	FIBRE ANALYSIS TECHNIQUES
FIBER BLENDS	FIBRE BLENDS	FIBRE BLENDS
FIBER BUNDLE	FIBRE BUNDLE	FIBRE BUNDLE
FIBER CHEMISTRIES	FIBRE CHEMISTRIES	FIBRE CHEMISTRIES
FIBER COATING	FIBRE COATING	FIBRE COATING
FIBER COLLECTION	FIBRE COLLECTION	FIBRE COLLECTION
FIBER COMPARISON	FIBRE COMPARISON	FIBRE COMPARISON
FIBER DEGRADATION	FIBRE DEGRADATION	FIBRE DEGRADATION
FIBER DISTRIBUTION	FIBRE DISTRIBUTION	FIBRE DISTRIBUTION
FIBER DRESSING	FIBRE DRESSING	FIBRE DRESSING
FIBER DYE IDENTIFICATION	FIBRE DYE IDENTIFICATION	FIBRE DYE IDENTIFICATION
FIBER DYES	FIBRE DYES	FIBRE DYES
FIBER END SURFACES	FIBRE END SURFACES	FIBRE END SURFACES
FIBER EVIDENCE	FIBRE EVIDENCE	FIBRE EVIDENCE
FIBER EXAMINATION	FIBRE EXAMINATION	FIBRE EXAMINATION
FIBER FINDER	FIBRE FINDER	FIBRE FINDER
FIBER FORENSIC COMPARISON	FIBRE FORENSIC COMPARISON	FIBRE FORENSIC COMPARISON
FIBER FORENSICS	FIBRE FORENSICS	FIBRE FORENSICS
FIBER FRACTURES	FIBRE FRACTURES	FIBRE FRACTURES
FIBER FREQUENCY	FIBRE FREQUENCY	FIBRE FREQUENCY
FIBER IDENTIFICATION	FIBRE IDENTIFICATION	FIBRE IDENTIFICATION
FIBER MATERIAL EVIDENCE	FIBRE MATERIAL EVIDENCE	FIBRE MATERIAL EVIDENCE
FIBER NETWORK	FIBRE NETWORK	FIBRE NETWORK
FIBER OPTIC	FIBRE OPTIC	FIBRE OPTIC
FIBER OPTIC PROBES	FIBRE OPTIC PROBES	FIBRE OPTIC PROBES
FIBER OPTIC SENSORS	FIBRE OPTIC SENSORS	FIBRE OPTIC SENSORS
FIBER OPTICS	FIBRE OPTICS	FIBRE OPTICS
FIBER ORIENTATION	FIBRE ORIENTATION	FIBRE ORIENTATION
FIBER PRODUCTION	FIBRE PRODUCTION	FIBRE PRODUCTION
FIBER PROPORTIONS	FIBRE PROPORTIONS	FIBRE PROPORTIONS
FIBER RECOVERY	FIBRE RECOVERY	FIBRE RECOVERY
FIBER REINFORCED CONCRETE	FIBRE REINFORCED CONCRETE	FIBRE REINFORCED CONCRETE
FIBER REINFORCED MATERIALS	FIBRE REINFORCED MATERIALS	FIBRE REINFORCED MATERIALS
FIBER SCALES	FIBRE SCALES	FIBRE SCALES
FIBER SOLID-PHASE MICROEXTRACTION	FIBRE SOLID-PHASE MICROEXTRACTION	FIBRE SOLID-PHASE MICROEXTRACTION
FIBER TIP PENS	FIBRE TIP PENS	FIBRE TIP PENS
FIBER TRACTOGRAPHY	FIBRE TRACTOGRAPHY	FIBRE TRACTOGRAPHY
FIBER TRANSFER	FIBRE TRANSFER	FIBRE TRANSFER
FIBER TYPES	FIBRE TYPES	FIBRE TYPES
FIBER: ACRYLIC BICOMPONENT	FIBRE: ACRYLIC BICOMPONENT	FIBRE: ACRYLIC BICOMPONENT
FIBER-END APPEARANCE	FIBRE-END APPEARANCE	FIBRE-END APPEARANCE
FIBER-ENHANCED RAMAN SPECTROSCOPY (FERS)	FIBRE-ENHANCED RAMAN SPECTROSCOPY (FERS)	(FERS)
FIBER-MELTING TRACES	FIBRE-MELTING TRACES	FIBRE-MELTING TRACES
FIBEROPTICS	FIBREOPTICS	FIBREOPTICS
FIBERS	FIBRE	FIBRE
FIBERS	FIBRE	FIBRE
FIBERS FORENSIC	FIBRE FORENSIC	FIBRE FORENSIC
FIBERS FORENSIC COMPARISON	FIBRE FORENSIC COMPARISON	FIBRE FORENSIC COMPARISON
FIBERSCOPE EXAMINATION	FIBRESCOPE EXAMINATION	FIBRESCOPE EXAMINATION
FIBER-SOLID PHASE MICROEXTRACTION (HF-SPME)	FIBRE-SOLID PHASE MICROEXTRACTION (HF-SPME)	(HF-SPME)
FIBER-TIP PEN INKS	FIBRE-TIP PEN INKS	FIBRE-TIP PEN INKS
FIBRES	FIBRE	FIBRE
FIBRES - FREQUENCY	FIBRE - FREQUENCY	FIBRE - FREQUENCY
FIBRES ANALYSIS	FIBRE ANALYSIS	FIBRE ANALYSIS
FIBRES AND TEXTILES	FIBRE AND TEXTILES	FIBRE AND TEXTILES
FIBRES EVIDENCE	FIBRE EVIDENCE	FIBRE EVIDENCE
FIBRES EXAMINATION	FIBRE EXAMINATION	FIBRE EXAMINATION
FIBRES IN HAIR	FIBRE IN HAIR	FIBRE IN HAIR
FIBRES RECOVERY	FIBRE RECOVERY	FIBRE RECOVERY
FIBRES TEXTILES	FIBRE TEXTILES	FIBRE TEXTILES
FIBRES: TRANSFER AND DISPERSAL	FIBRE: TRANSFER AND DISPERSAL	FIBRE: TRANSFER AND DISPERSAL
FIELD TESTS	FIELD TEST	FIELD TEST
FINGERMARK	FINGERPRINT	FINGERPRINT
FINGERMARKS	FINGERPRINT	FINGERPRINT
FINGERPRINTS	FINGERPRINT	FINGERPRINT
FINGERS	FINGER	FINGER
FIREARM DISCHARGE RESIDUE	FIREARM DISCHARGE RESIDUE (FDR)	FIREARM DISCHARGE RESIDUE (FDR)
FIREARM DISCHARGE RESIDUES	FIREARM DISCHARGE RESIDUE (FDR)	FIREARM DISCHARGE RESIDUE (FDR)
FIREARMS	FIREARM	FIREARM
FIREARMS DISCHARGE RESIDUE (FDR)	FIREARM DISCHARGE RESIDUE (FDR)	FIREARM DISCHARGE RESIDUE (FDR)
FIRING DISTANCE	SHOOTING DISTANCE DETERMINATION	SHOOTING DISTANCE DETERMINATION
FIRING RANGE	SHOOTING DISTANCE DETERMINATION	SHOOTING DISTANCE DETERMINATION
FIRING RANGE DETERMINATION	SHOOTING DISTANCE DETERMINATION	SHOOTING DISTANCE DETERMINATION
FIRING RANGES	SHOOTING DISTANCE DETERMINATION	SHOOTING DISTANCE DETERMINATION
FLUORENES	FLUORENE	FLUORENE
FORENSIC	FORENSIC SCIENCE	FORENSIC SCIENCE
FORENSIC SAMPLES	FORENSIC SAMPLE	FORENSIC SAMPLE
FORENSIC SCIENCES	FORENSIC SCIENCE	FORENSIC SCIENCE
FORENSIC SCIENTISTS	FORENSIC SCIENTIST	FORENSIC SCIENTIST
FORENSICS	FORENSIC SCIENCE	FORENSIC SCIENCE
FOURIER TRANSFORM INFRA RED (FTIR) SPECTROSCOPY	FOURIER-TRANSFORM INFRARED SPECTROSCOPY (FT-IR)	(FT-IR)
FOURIER TRANSFORM INFRARED	FOURIER-TRANSFORM INFRARED SPECTROSCOPY (FT-IR)	(FT-IR)
FOURIER TRANSFORM INFRARED (FT-IR) MICROSPECTROSCOPY	FOURIER-TRANSFORM INFRARED SPECTROSCOPY (FT-IR)	(FT-IR)
FOURIER TRANSFORM INFRARED MICROANALYSIS	FOURIER-TRANSFORM INFRARED SPECTROSCOPY (FT-IR)	(FT-IR)
FOURIER TRANSFORM INFRARED MICROSPECTROSCOPY	FOURIER-TRANSFORM INFRARED SPECTROSCOPY (FT-IR)	(FT-IR)
FOURIER TRANSFORM INFRARED SPECTROSCOPY	FOURIER-TRANSFORM INFRARED SPECTROSCOPY (FT-IR)	(FT-IR)
FOURIER TRANSFORM INFRARED-MICROSCOPY MICROSPECTROPHOTOMETRY	FOURIER-TRANSFORM INFRARED SPECTROSCOPY (FT-IR)	(FT-IR)
FREQUENCIES	FREQUENCY	FREQUENCY
FTIR	FOURIER-TRANSFORM INFRARED SPECTROSCOPY (FT-IR)	(FT-IR)
FTIR	FOURIER-TRANSFORM INFRARED SPECTROSCOPY (FT-IR)	(FT-IR)
FT-IR	FOURIER-TRANSFORM INFRARED SPECTROSCOPY (FT-IR)	(FT-IR)
FT-IR	FOURIER-TRANSFORM INFRARED SPECTROSCOPY (FT-IR)	(FT-IR)
FTIR MICROSCOPY	FOURIER-TRANSFORM INFRARED SPECTROSCOPY (FT-IR)	(FT-IR)
FT-IR MICROSCOPY IN FORENSIC LABORATORIES	FOURIER-TRANSFORM INFRARED SPECTROSCOPY (FT-IR)	(FT-IR)
FTIR SPECTROSCOPY	FOURIER-TRANSFORM INFRARED SPECTROSCOPY (FT-IR)	(FT-IR)
FT-IR SPECTROSCOPY	FOURIER-TRANSFORM INFRARED SPECTROSCOPY (FT-IR)	(FT-IR)
FTIR)	FOURIER-TRANSFORM INFRARED SPECTROSCOPY (FT-IR)	(FT-IR)
FTIR-MICROSPECTROSCOPY	FOURIER-TRANSFORM INFRARED SPECTROSCOPY (FT-IR)	(FT-IR)
GAS CHROMATOGRAPHY	GAS CHROMATOGRAPHY (GC)	GAS CHROMATOGRAPHY (GC)
GAS CHROMATOGRAPHY/MASS	GAS CHROMATOGRAPHY–MASS SPECTROMETRY (GC–MS)	(GC–MS)
GAS CHROMATOGRAPHY/MASS SPECTROMETRY	GAS CHROMATOGRAPHY-MASS SPECTROMETRY (GC-MS)	(GC-MS)
GAS CHROMATOGRAPHY/MASS SPECTROMETRY	GAS CHROMATOGRAPHY–MASS SPECTROMETRY (GC–MS)	(GC–MS)
GAS CHROMATOGRAPHY/MS SPECTROMETRY	GAS CHROMATOGRAPHY–MASS SPECTROMETRY (GC–MS)	(GC–MS)
GAS CHROMATOGRAPHY?ÇôMASS SPECTROMETRY (GC?ÇôMS)	GAS CHROMATOGRAPHY-MASS SPECTROMETRY (GC-MS)	(GC-MS)
GAS CHROMATOGRAPHY-ISOTOPE RATIO MASS SPECTROMETRY	GAS CHROMATOGRAPHY–MASS SPECTROMETRY (GC–MS)	(GC–MS)
GAS CHROMATOGRAPHY-MASS SPECTROMETRY	GAS CHROMATOGRAPHY-MASS SPECTROMETRY (GC-MS)	(GC-MS)
GAS CHROMATOGRAPHY-MASS SPECTROMETRY	GAS CHROMATOGRAPHY–MASS SPECTROMETRY (GC–MS)	(GC–MS)
GAS CHROMATOGRAPHY-THERMAL ENERGY ANALYZER	GAS CHROMATOGRAPHY-THERMAL ENERGY ANALYZER (GC-TEA)	(GC-TEA)
GC	GAS CHROMATOGRAPHY (GC)	GAS CHROMATOGRAPHY (GC)
GC/MS	GAS CHROMATOGRAPHY-MASS SPECTROMETRY (GC-MS)	(GC-MS)
GC/MS	GAS CHROMATOGRAPHY–MASS SPECTROMETRY (GC–MS)	(GC–MS)
GC/TEA	GAS CHROMATOGRAPHY-THERMAL ENERGY ANALYZER (GC-TEA)	(GC-TEA)
GC-MS	GAS CHROMATOGRAPHY-MASS SPECTROMETRY (GC-MS)	(GC-MS)
GC-MS	GAS CHROMATOGRAPHY–MASS SPECTROMETRY (GC–MS)	(GC–MS)
GC-TEA	GAS CHROMATOGRAPHY-THERMAL ENERGY ANALYZER (GC-TEA)	(GC-TEA)
GOATS	GOAT	GOAT
GREY COTTON	COTTON	COTTON
GSR	GUNSHOT RESIDUE (GSR)	GUNSHOT RESIDUE (GSR)
GSR (GUNSHOT RESIDUE)	GUNSHOT RESIDUE (GSR)	GUNSHOT RESIDUE (GSR)
GSR ANALYSIS	GUNSHOT RESIDUE ANALYSIS	GUNSHOT RESIDUE ANALYSIS
GSR CONTAMINATION	GUNSHOT RESIDUE CONTAMINATION	GUNSHOT RESIDUE CONTAMINATION
GSR PARTICLES	GUNSHOT RESIDUE (GSR)	GUNSHOT RESIDUE (GSR)
GSR PATTERN	GUNSHOT RESIDUE PATTERN	GUNSHOT RESIDUE PATTERN
GUN	FIREARM	FIREARM
GUN SHOT RESIDUE	GUNSHOT RESIDUE (GSR)	GUNSHOT RESIDUE (GSR)
GUN SHOT RESIDUES	GUNSHOT RESIDUE (GSR)	GUNSHOT RESIDUE (GSR)
GUNPOWDER RESIDUES	GUNPOWDER RESIDUE	GUNPOWDER RESIDUE
GUNS	FIREARM	FIREARM
GUNSHOT RESIDUE	GUNSHOT RESIDUE (GSR)	GUNSHOT RESIDUE (GSR)
GUNSHOT RESIDUE (GSR) ANALYSIS	GUNSHOT RESIDUE ANALYSIS	GUNSHOT RESIDUE ANALYSIS
GUNSHOT RESIDUE PARTICLES	GUNSHOT RESIDUE PARTICLE	GUNSHOT RESIDUE PARTICLE
GUNSHOT RESIDUE PATTERNS	GUNSHOT RESIDUE PATTERN	GUNSHOT RESIDUE PATTERN
GUNSHOT RESIDUE(GSR)	GUNSHOT RESIDUE (GSR)	GUNSHOT RESIDUE (GSR)
GUNSHOT RESIDUES	GUNSHOT RESIDUE (GSR)	GUNSHOT RESIDUE (GSR)
GUNSHOT RESIDUES (GSR)	GUNSHOT RESIDUE (GSR)	GUNSHOT RESIDUE (GSR)
GUNSHOT RESIDUES (GSRS)	GUNSHOT RESIDUE (GSR)	GUNSHOT RESIDUE (GSR)
GUNSHOT RESIDUES(GSRS)	GUNSHOT RESIDUE (GSR)	GUNSHOT RESIDUE (GSR)
GUN-SHOT WOUND	GUNSHOT WOUND	GUNSHOT WOUND
GUNSHOT WOUNDS	GUNSHOT WOUND	GUNSHOT WOUND
HAIRS	HAIR	HAIR
HAND-GUN	HANDGUN	HANDGUN
HANDGUNS	HANDGUN	HANDGUN
HEAD HAIR	HAIR	HAIR
HEAVY METALS	HEAVY METAL	HEAVY METAL
HIGH PERFORMANCE LIQUID CHROMATOGRAPHY	HIGH-PERFORMANCE LIQUID CHROMATOGRAPHY (HPLC)	(HPLC)
HIGH PERFORMANCE LIQUID CHROMATOGRAPHY DIODE ARRAY DETECTOR	HIGH-PERFORMANCE LIQUID CHROMATOGRAPHY (HPLC)	(HPLC)
HIGH PERFORMANCE THIN LAYER CHROMATOGRAPHY	HIGH PERFORMANCE THIN-LAYER CHROMATOGRAPHY (HPTLC)	(HPTLC)
HIGH-PERFORMANCE LIQUID CHROMATOGRAPHY	HIGH PRESSURE LIQUID CHROMATOGRAPHY (HPLC)	(HPLC)
HIGH-PERFORMANCE LIQUID CHROMATOGRAPHY-DIODE ARRAY DETECTION	HIGH-PERFORMANCE LIQUID CHROMATOGRAPHY (HPLC)	(HPLC)
HOLLOW FIBER LIQUID PHASE MICROEXTRACTION	HOLLOW-FIBRE LIQUID-PHASE MICROEXTRACTION (HF-LPME)	(HF-LPME)
HOLLOW FIBER-LIQUID PHASE MICROEXTRACTION	HOLLOW-FIBRE LIQUID-PHASE MICROEXTRACTION (HF-LPME)	(HF-LPME)
HOLLOW FIBER-LIQUID PHASE MICROEXTRACTION (HF-LPME)	HOLLOW-FIBRE LIQUID-PHASE MICROEXTRACTION (HF-LPME)	(HF-LPME)
HOLLOW FIBRE LIQUID-PHASE MICROEXTRACTION (HF-LPME)	HOLLOW-FIBRE LIQUID-PHASE MICROEXTRACTION (HF-LPME)	(HF-LPME)
HOLLOW-FIBER LIQUID-PHASE MICROEXTRACTION	HOLLOW-FIBRE LIQUID-PHASE MICROEXTRACTION (HF-LPME)	(HF-LPME)
HOLLOW-FIBER LIQUID-PHASE MICROEXTRACTION (HF-LPME)	HOLLOW-FIBRE LIQUID-PHASE MICROEXTRACTION (HF-LPME)	(HF-LPME)
HORSES	HORSE	HORSE
HPLC	HIGH-PERFORMANCE LIQUID CHROMATOGRAPHY (HPLC)	(HPLC)
HUMANS	HUMAN	HUMAN
ICP OES	INDUCTIVELY COUPLE PLASMA/OPTICAL EMISSION SPECTROMETRY (ICP/OES)	(ICP/OES)
ICP/OES	INDUCTIVELY COUPLE PLASMA/OPTICAL EMISSION SPECTROMETRY (ICP/OES)	(ICP/OES)
ICP-AES	INDUCTIVELY COUPLED PLASMA ATOMIC EMISSION SPECTROMETRY (ICP-AES)	(ICP-AES)
ICP-MS	(ICP-MS)	(ICP-MS)
IGSR	INORGANIC GUNSHOT RESIDUE (IGSR)	INORGANIC GUNSHOT RESIDUE (IGSR)
IMAGES	IMAGE	IMAGE
IMS	ION MOBILITY SPECTROMETRY (IMS)	ION MOBILITY SPECTROMETRY (IMS)
INDUCTIVE COUPLED PLASMA	INDUCTIVELY COUPLED PLASMA (ICP)	INDUCTIVELY COUPLED PLASMA (ICP)
INDUCTIVELY COUPLED PLASMA	INDUCTIVELY COUPLED PLASMA (ICP)	INDUCTIVELY COUPLED PLASMA (ICP)
INDUCTIVELY COUPLED PLASMA ATOMIC EMISSION SPECTROMETER ANALYSIS	INDUCTIVELY COUPLED PLASMA ATOMIC EMISSION SPECTROMETRY (ICP-AES)	(ICP-AES)
INDUCTIVELY COUPLED PLASMA MASS SPECTROMETRY	(ICP-MS)	(ICP-MS)
INDUCTIVELY COUPLED PLASMA OPTICAL EMISSION SPECTROMETRY	INDUCTIVELY COUPLE PLASMA/OPTICAL EMISSION SPECTROMETRY (ICP/OES)	(ICP/OES)
INDUCTIVELY COUPLED PLASMA-MASS SPECTROMETRY	(ICP-MS)	(ICP-MS)
INFRARED	INFRARED (IR)	INFRARED (IR)
INFRARED (FT-IR) MICROSPECTROSCOPY	FOURIER-TRANSFORM INFRARED SPECTROSCOPY (FT-IR)	(FT-IR)
INFRARED MICROSPECTROMETRY	INFRARED SPECTROSCOPY (IR)	INFRARED SPECTROSCOPY (IR)
INFRARED MICROSPECTROSCOPY	INFRARED SPECTROSCOPY (IR)	INFRARED SPECTROSCOPY (IR)
INFRARED MICROSPECTROSCOPY FTIR	FOURIER-TRANSFORM INFRARED SPECTROSCOPY (FT-IR)	(FT-IR)
INFRARED MICROSPECTROSCOPY FT-IR	FOURIER-TRANSFORM INFRARED SPECTROSCOPY (FT-IR)	(FT-IR)
INFRARED MISCROSPECTROMETRY	INFRARED SPECTROSCOPY (IR)	INFRARED SPECTROSCOPY (IR)
INFRARED SPECTRAL	INFRARED SPECTROSCOPY (IR)	INFRARED SPECTROSCOPY (IR)
INFRARED SPECTROMETRY	INFRARED SPECTROSCOPY (IR)	INFRARED SPECTROSCOPY (IR)
INFRARED SPECTROPHOTOMETRY	INFRARED SPECTROSCOPY (IR)	INFRARED SPECTROSCOPY (IR)
INFRARED SPECTROSCOPY	INFRARED SPECTROSCOPY (IR)	INFRARED SPECTROSCOPY (IR)
INFRA-RED SPECTROSCOPY	INFRARED SPECTROSCOPY (IR)	INFRARED SPECTROSCOPY (IR)
INFRA-RED SPECTROSCOPY (IR)	INFRARED SPECTROSCOPY (IR)	INFRARED SPECTROSCOPY (IR)
INJURIES	INJURY	INJURY
INKS	INK	INK
INORGANIC GSR	INORGANIC GUNSHOT RESIDUE (IGSR)	INORGANIC GUNSHOT RESIDUE (IGSR)
INORGANIC GSR (IGSR)	INORGANIC GUNSHOT RESIDUE (IGSR)	INORGANIC GUNSHOT RESIDUE (IGSR)
INORGANIC GUNSHOT RESIDUE	INORGANIC GUNSHOT RESIDUE (IGSR)	INORGANIC GUNSHOT RESIDUE (IGSR)
INTERPRTATION BAYSIENNE	BAYESIAN APPROACH	BAYESIAN APPROACH
ION BEAM ANALYSIS	ION BEAM ANALYSIS (IBA)	ION BEAM ANALYSIS (IBA)
ION MOBILITY SPECTROMETERS	ION MOBILITY SPECTROMETRY (IMS)	ION MOBILITY SPECTROMETRY (IMS)
ION MOBILITY SPECTROMETRY	ION MOBILITY SPECTROMETRY (IMS)	ION MOBILITY SPECTROMETRY (IMS)
IONIZATION SOURCES	IONIZATION SOURCE	IONIZATION SOURCE
IR SPECTROSCOPY	INFRARED SPECTROSCOPY (IR)	INFRARED SPECTROSCOPY (IR)
IRS	INFRARED SPECTROSCOPY (IR)	INFRARED SPECTROSCOPY (IR)
ISOTOPES	ISOTOPE	ISOTOPE
LABORATORIES	LABORATORY	LABORATORY
LANTHANIDES	LANTHANIDE	LANTHANIDE
LASER ABLATION INDUCTIVELY-COUPLED PLASMA MASS SPECTROMETRIES	LASER ABLATION INDUCTIVELY COUPLED PLASMA MASS SPECTROMETRY	LASER ABLATION INDUCTIVELY COUPLED PLASMA MASS SPECTROMETRY
LASER INDUCED BREAKDOWN SPECTROMETERS	LASER-INDUCED BREAKDOWN SPECTROSCOPY (LIBS)	(LIBS)
LASER INDUCED BREAKDOWN SPECTROSCOPY	LASER-INDUCED BREAKDOWN SPECTROSCOPY (LIBS)	(LIBS)
LASER-INDUCED BREAKDOWN SPECTROSCOPY	LASER-INDUCED BREAKDOWN SPECTROSCOPY (LIBS)	(LIBS)
LASERINDUCED BREAKDOWN SPECTROSCOPY (LIBS)	LASER-INDUCED BREAKDOWN SPECTROSCOPY (LIBS)	(LIBS)
LATENT FINGERPRINTS	LATENT FINGERPRINT	LATENT FINGERPRINT
LC?ÇôMS	LIQUID CHROMATOGRAPHY-MASS SPECTROSCOPY-MASS SPECTROSCOPY (LC-MS/MS)	(LC-MS/MS)
LC-MS	LIQUID CHROMATOGRAPHY-MASS SPECTROSCOPY (LC-MS)	(LC-MS)
LC-MS/MS	LIQUID CHROMATOGRAPHY-MASS SPECTROSCOPY-MASS SPECTROSCOPY (LC-MS/MS)	(LC-MS/MS)
LEAD	LEAD (PB)	LEAD (PB)
LEAD ISOTOPES	LEAD ISOTOPE	LEAD ISOTOPE
LEAD-FREE	LEAD-FREE AMMUNITION	LEAD-FREE AMMUNITION
LEADFREE AMMUNITION	LEAD-FREE AMMUNITION	LEAD-FREE AMMUNITION
LEAD-FREE CARTRIDGES	LEAD-FREE AMMUNITION	LEAD-FREE AMMUNITION
LEAD-FREE PRIMER RESIDUE	LEAD-FREE AMMUNITION	LEAD-FREE AMMUNITION
LEAD-FREE PRIMERS	LEAD-FREE AMMUNITION	LEAD-FREE AMMUNITION
LEADLESS	LEAD-FREE AMMUNITION	LEAD-FREE AMMUNITION
LEADLESS PRIMERS	LEAD-FREE AMMUNITION	LEAD-FREE AMMUNITION
LIBS	LASER-INDUCED BREAKDOWN SPECTROSCOPY (LIBS)	(LIBS)
LIKELIHOOD RATIO LR	LIKELIHOOD RATIO	LIKELIHOOD RATIO
LIKELIHOOD RATIOS	LIKELIHOOD RATIO	LIKELIHOOD RATIO
LIQUID CHROMATOGRAPHY	LIQUID CHROMATOGRAPHY (LC)	LIQUID CHROMATOGRAPHY (LC)
LUMINESCENT MARKERS	LUMINESCENT MARKER	LUMINESCENT MARKER
MASS SPECTROMETER	MASS SPECTROMETRY (MS)	MASS SPECTROMETRY (MS)
MASS SPECTROMETER (MS)	MASS SPECTROMETRY (MS)	MASS SPECTROMETRY (MS)
MASS SPECTROMETERS	MASS SPECTROMETRY (MS)	MASS SPECTROMETRY (MS)
MASS SPECTROMETRY	MASS SPECTROMETRY (MS)	MASS SPECTROMETRY (MS)
MASS-SPECTROMETRY IMAGING	MASS SPECTROMETRY IMAGING (MSI)	MASS SPECTROMETRY IMAGING (MSI)
MEATS	MEAT	MEAT
MERCURY (ELEMENT)	MERCURY	MERCURY
METAL ORGANIC FRAMEWORK	METAL ORGANIC FRAMEWORK (MOF)	METAL ORGANIC FRAMEWORK (MOF)
METAL-ORGANIC FRAMEWORK	METAL ORGANIC FRAMEWORK (MOF)	METAL ORGANIC FRAMEWORK (MOF)
METAL-ORGANIC FRAMEWORKS	METAL ORGANIC FRAMEWORK (MOF)	METAL ORGANIC FRAMEWORK (MOF)
METALORGANIC FRAMEWORKS (MOFS)	METAL ORGANIC FRAMEWORK (MOF)	METAL ORGANIC FRAMEWORK (MOF)
METALS	METAL	METAL
"METALS, HEAVY"	HEAVY METALS	HEAVY METALS
METHYL CENTRALITE	METHYL CENTRALITE (MC)	METHYL CENTRALITE (MC)
METHYLCENTRALITE	METHYL CENTRALITE (MC)	METHYL CENTRALITE (MC)
MICELLAR ELECTRO-KINETIC CHROMATOGRAPHY	MICELLAR ELECTROKINETIC CHROMATOGRAPHY	MICELLAR ELECTROKINETIC CHROMATOGRAPHY
MICELLE	MICELLES	MICELLES
MICRO RAMAN SPECTROSCOPY	RAMAN	RAMAN
MICROCT	MICRO-CT	MICRO-CT
MICROELECTRODES	MICROELECTRODE	MICROELECTRODE
"MICROSCOPES, ELECTRON"	ELECTRON MICROSCOPY	ELECTRON MICROSCOPY
"MICROSCOPY, ACOUSTIC"	ACOUSTIC MICROSCOPY	ACOUSTIC MICROSCOPY
"MICROSCOPY, CONFOCAL"	CONFOCAL MICROSCOPY	CONFOCAL MICROSCOPY
"MICROSCOPY, ELECTRON"	ELECTRON MICROSCOPY	ELECTRON MICROSCOPY
"MICROSCOPY, ELECTRON, SCANNING"	SCANNING ELECTRON MICROSCOPY (SEM)	(SEM)
"MICROSCOPY, ELECTRON, SCANNING"	ELECTRON MICROSCOPY	ELECTRON MICROSCOPY
"MICROSCOPY, ELECTRON, TRANSMISSION"	ELECTRON MICROSCOPY	ELECTRON MICROSCOPY
"MICROSCOPY, FLUORESCENCE"	FLUORESCENCE MICROSCOPY	FLUORESCENCE MICROSCOPY
MICROSPECTROPHOTOMETER	MICROSPECTROPHOTOMETRY (MSP)	MICROSPECTROPHOTOMETRY (MSP)
MICROSPECTROPHOTOMETRY	MICROSPECTROPHOTOMETRY (MSP)	MICROSPECTROPHOTOMETRY (MSP)
MIDDLE AGED	MIDDLE AGE	MIDDLE AGE
MOFS	METAL ORGANIC FRAMEWORK (MOF)	METAL ORGANIC FRAMEWORK (MOF)
MSP	MICROSPECTROPHOTOMETRY (MSP)	MICROSPECTROPHOTOMETRY (MSP)
MULTIVARIATE STATISTICAL METHODS	MULTIVARIATE STATISTICAL ANALYSIS	MULTIVARIATE STATISTICAL ANALYSIS
"N,N?Ç? -DIPHENYL-N,N?Ç? -DIETHYLUREA (ETHYL CENTRALITE)"	"N,N'-DIPHENYL-N,N'- DIETHYLUREA (ETHYL CENTRALITE)"	(ETHYL CENTRALITE)
NAA	NEUTRON ACTIVATION ANALYSIS (NAA)	NEUTRON ACTIVATION ANALYSIS (NAA)
NAPHTHALENES	NAPHTHALENE	NAPHTHALENE
NEUTRON ACTIVATION ANALYSIS	NEUTRON ACTIVATION ANALYSIS (NAA)	NEUTRON ACTIVATION ANALYSIS (NAA)
NOSE HAIRS	NOSE HAIR	NOSE HAIR
NUCLEAR MAGNETIC RESONANCE	NUCLEAR MAGNETIC RESONANCE (NMR)	NUCLEAR MAGNETIC RESONANCE (NMR)
NUCLEIC ACIDS	NUCLEIC ACID	NUCLEIC ACID
NYLON FIBER	NYLON	NYLON
NYLONS	NYLON	NYLON
OCCUPATIONS	OCCUPATION	OCCUPATION
OGSR	ORGANIC GUNSHOT RESIDUE (OGSR)	ORGANIC GUNSHOT RESIDUE (OGSR)
ORGANIC GUN SHOT RESIDUE (OGSR)	ORGANIC GUNSHOT RESIDUE (OGSR)	ORGANIC GUNSHOT RESIDUE (OGSR)
ORGANIC GUNSHOT RESIDUE	ORGANIC GUNSHOT RESIDUE (OGSR)	ORGANIC GUNSHOT RESIDUE (OGSR)
ORGANIC GUNSHOT RESIDUES	ORGANIC GUNSHOT RESIDUE (OGSR)	ORGANIC GUNSHOT RESIDUE (OGSR)
OXIDES	OXIDE	OXIDE
PAINTS	PAINT	PAINT
PARTICLE INDUCED X RAY EMISSION	PARTICLE INDUCED X-RAY EMISSION (PIXE)	(PIXE)
PARTICLE INDUCED X-RAY EMISSION	PARTICLE INDUCED X-RAY EMISSION (PIXE)	(PIXE)
PATTERNS	PATTERN	PATTERN
PHOSPHATES	PHOSPHATE	PHOSPHATE
PIXE	PARTICLE INDUCED X-RAY EMISSION (PIXE)	(PIXE)
PIXE MEASUREMENTS	PARTICLE INDUCED X-RAY EMISSION (PIXE)	(PIXE)
POLARIZED CONFOCAL RAMAN MICROSPECTROSCOPY	RAMAN	RAMAN
POLARIZED LIGHT	POLARIZED LIGHT MICROSCOPY	POLARIZED LIGHT MICROSCOPY
POLARIZING LIGHT MICROSCOPE	POLARIZED LIGHT MICROSCOPY	POLARIZED LIGHT MICROSCOPY
POLYESTER (TERENE)	POLYESTER	POLYESTER
POLYESTER FIBER	POLYESTER	POLYESTER
POLYESTER FIBERS	POLYESTER	POLYESTER
POLYESTER FIBRES	POLYESTER	POLYESTER
POLYESTERS	POLYESTER	POLYESTER
POLYETHYLENE TEREPHTHALATE	POLYETHYLENE	POLYETHYLENE
POLYETHYLENE TEREPHTHALATE (PET)	POLYETHYLENE	POLYETHYLENE
POLYMER VARIATION	POLYMER	POLYMER
POLYMERS	POLYMER	POLYMER
POLYPRO PYLENE	POLYPROPYLENE	POLYPROPYLENE
POPULATION STUDIES	POPULATION STUDY	POPULATION STUDY
POST MORTEM INTERVALS	POST MORTEM INTERVAL (PMI)	POST MORTEM INTERVAL (PMI)
POSTMORTEM CHANGE	POSTMORTEM CHANGES	POSTMORTEM CHANGES
POWDER PATTERNS	POWDER PATTERN	POWDER PATTERN
POWDER TATTOOING	POWDER TATTOO	POWDER TATTOO
POWDERS	POWDER	POWDER
PRIMERS	PRIMER	PRIMER
PRINCIPAL COMPONENT	PRINCIPAL COMPONENT ANALYSIS (PCA)	(PCA)
PRINCIPAL COMPONENT ANALYSIS	PRINCIPAL COMPONENT ANALYSIS (PCA)	(PCA)
PROCEDURE	PROCEDURES	PROCEDURES
PROPELLANTS	PROPELLANT	PROPELLANT
PYROTECHNIC REACTION RESIDUES	PYROTECHNIC REACTION RESIDUE	PYROTECHNIC REACTION RESIDUE
QUESTIONNAIRE	QUESTIONNAIRES	QUESTIONNAIRES
RAMAN IMAGING	RAMAN	RAMAN
"RAMAN MAPPING TECHNOLOGIES, AND MINIMUM FIBRE DIAMETER"	RAMAN	RAMAN
RAMAN MICROSCOPE	RAMAN	RAMAN
RAMAN MICROSCOPICAL	RAMAN	RAMAN
RAMAN MICROSCOPICAL ANALYSIS	RAMAN	RAMAN
RAMAN MICROSCOPY	RAMAN	RAMAN
RAMAN MICROSPECTROSCOPY	RAMAN	RAMAN
RAMAN SCATTERING	RAMAN	RAMAN
RAMAN SPECTRAL IMAGING	RAMAN	RAMAN
RAMAN SPECTROMETRY	RAMAN	RAMAN
RAMAN SPECTROSCOPY	RAMAN	RAMAN
RAMAN TECHNIQUES	RAMAN	RAMAN
RANK CORRELATION COEFFICIENTS: R-SPEARMAN AND ?ä-KENDALL	RANK CORRELATION COEFFICIENTS: R-SPEARMAN AND ??-KENDALL	RANK CORRELATION COEFFICIENTS: R-SPEARMAN AND ??-KENDALL
RATS	RAT	RAT
REACTION BAND-LENGTH ??PAD	REACTION BAND-LENGTH PAD	REACTION BAND-LENGTH PAD
REACTIVE DYES	REACTIVE DYE	REACTIVE DYE
RED COTTON	COTTON	COTTON
REVIEW [PUBLICATION TYPE]	REVIEW	REVIEW
REVOLVERS	REVOLVER	REVOLVER
RIB	RIBS	RIBS
SCANNING ACOUSTIC MICROSCOPY	SCANNING ACOUSTIC MICROSCOPY (SAM)	(SAM)
SCANNING ELECTRO MICROSCOPY-ENERGY DISPERSIVE X-RAY ANALYSIS	(SEM-EDS)	(SEM-EDS)
SCANNING ELECTROMICROSCOPY ENERGY DISPERSIVE X-RAY ANALYSIS	(SEM-EDS)	(SEM-EDS)
SCANNING ELECTRON	SCANNING ELECTRON MICROSCOPY (SEM)	(SEM)
SCANNING ELECTRON MICROSCOPE	SCANNING ELECTRON MICROSCOPY (SEM)	(SEM)
SCANNING ELECTRON MICROSCOPE (SEM)	SCANNING ELECTRON MICROSCOPY (SEM)	(SEM)
SCANNING ELECTRON MICROSCOPE/ENERGY DISPERSIVE X-RAY ANALYSIS	(SEM-EDS)	(SEM-EDS)
SCANNING ELECTRON MICROSCOPE-ENERGY DISPERSIVE X-RAY SPECTROMETER	(SEM-EDS)	(SEM-EDS)
SCANNING ELECTRON MICROSCOPES	SCANNING ELECTRON MICROSCOPY (SEM)	(SEM)
SCANNING ELECTRON MICROSCOPY	SCANNING ELECTRON MICROSCOPY (SEM)	(SEM)
SCANNING ELECTRON MICROSCOPY AND ENERGY DISPERSIVE X-RAY SPECTROMETRY	(SEM-EDS)	(SEM-EDS)
SCANNING ELECTRON MICROSCOPY AND ENERGY-DISPERSIVE X-RAY ANALYSIS (SEM-EDX)	(SEM-EDS)	(SEM-EDS)
SCANNING ELECTRON MICROSCOPY ENERGY DISPERSIVE X-RAY SPECTROSCOPY	(SEM-EDS)	(SEM-EDS)
SCANNING ELECTRON MICROSCOPY/ENERGY DISPERSIVE SPECTROSCOPY	(SEM-EDS)	(SEM-EDS)
SCANNING ELECTRON MICROSCOPY/ENERGY DISPERSIVE X-RAY ANALYSIS	(SEM-EDS)	(SEM-EDS)
SCANNING ELECTRON MICROSCOPY/ENERGY DISPERSIVE X-RAY SPECTROMETRY	(SEM-EDS)	(SEM-EDS)
SCANNING ELECTRON MICROSCOPY/ENERGY DISPERSIVE X-RAY SPECTROSCOPY (SEM/EDX)	(SEM-EDS)	(SEM-EDS)
SCANNING ELECTRON MICROSCOPY/ENERGY-DISPERSIVE SPECTROMETRY	(SEM-EDS)	(SEM-EDS)
SCANNING ELECTRON MICROSCOPY/ENERGY-DISPERSIVE SPECTROMETRY (SEM/EDS)	(SEM-EDS)	(SEM-EDS)
SCANNING ELECTRON MICROSCOPY/ENERGY-DISPERSIVE SPECTROSCOPY	(SEM-EDS)	(SEM-EDS)
SCANNING ELECTRON MICROSCOPY-ENERGY DISPERSIVE X-RAY ANALYSIS	(SEM-EDS)	(SEM-EDS)
SCANNING ELECTRON MICROSCOPY-ENERGY-DISPERSIVE X-RAY DETECTOR (SEM-EDX)	(SEM-EDS)	(SEM-EDS)
SCHU?ƒ	SHOOTING	SHOOTING
"SCHU?ƒENTFERNUNG, TEXTILVER?ñNDERUNGEN"	SHOOTING DISTANCE DETERMINATION	SHOOTING DISTANCE DETERMINATION
SCHU?ƒENTFERNUNGSBESTIMMUNG	SHOOTING DISTANCE DETERMINATION	SHOOTING DISTANCE DETERMINATION
SCIENTISTS	SCIENTIST	SCIENTIST
SECONDARY ION MASS SPECTROMETRY	SECONDARY ION MASS SPECTROMETRY (SIMS)	(SIMS)
SELENIUM OXIDES	SELENIUM OXIDE	SELENIUM OXIDE
SEM	SCANNING ELECTRON MICROSCOPY (SEM)	(SEM)
SEM + EDS	(SEM-EDS)	(SEM-EDS)
SEM ANALYSIS	SCANNING ELECTRON MICROSCOPY (SEM)	(SEM)
SEM/EDS	(SEM-EDS)	(SEM-EDS)
SEM/EDS ANALYSIS	(SEM-EDS)	(SEM-EDS)
SEM/EDX	(SEM-EDS)	(SEM-EDS)
SEM/EDX ANALYSIS	(SEM-EDS)	(SEM-EDS)
SEM?ÇôEDX	(SEM-EDS)	(SEM-EDS)
SEM-EDS	(SEM-EDS)	(SEM-EDS)
SEM-EDS EXAMINATION	(SEM-EDS)	(SEM-EDS)
SEM-EDX	(SEM-EDS)	(SEM-EDS)
SEM-EDX ANALYSIS	(SEM-EDS)	(SEM-EDS)
SEM-EDXA	(SEM-EDS)	(SEM-EDS)
SENSITIVITY ANALYSES	SENSITIVITY ANALYSIS	SENSITIVITY ANALYSIS
SHOOTING DISTANCE	SHOOTING DISTANCE DETERMINATION	SHOOTING DISTANCE DETERMINATION
SHOOTING DISTANCE ESTIMATION	SHOOTING DISTANCE DETERMINATION	SHOOTING DISTANCE DETERMINATION
SHOOTING-DISTANCE DETERMINATION	SHOOTING DISTANCE DETERMINATION	SHOOTING DISTANCE DETERMINATION
SILICONES	SILICONE	SILICONE
SIMS	SECONDARY ION MASS SPECTROMETRY (SIMS)	(SIMS)
SINGLE FIBER	SINGLE FIBRE	SINGLE FIBRE
SINGLE FIBERS	SINGLE FIBRE	SINGLE FIBRE
SINGLE FIBRES	SINGLE FIBRE	SINGLE FIBRE
SODIUM RHODIZONATE	SODIUM RHODIZONATE TEST (SRT)	SODIUM RHODIZONATE TEST (SRT)
SODIUM RHODIZONATE TEST	SODIUM RHODIZONATE TEST (SRT)	SODIUM RHODIZONATE TEST (SRT)
SOLID PHASE EXTRACTION	SOLID PHASE EXTRACTION (SPE)	SOLID PHASE EXTRACTION (SPE)
SOLID PHASE MICRO EXTRACTION	SOLID-PHASE MICROEXTRACTION (SPME)	(SPME)
SOLID PHASE MICRO EXTRACTION (SPME)	SOLID-PHASE MICROEXTRACTION (SPME)	(SPME)
SOLID PHASE MICROEXTRACTION	SOLID PHASE MICRO-EXTRACTION (SPME)	(SPME)
SOLID PHASE MICROEXTRACTION	SOLID-PHASE MICROEXTRACTION (SPME)	(SPME)
SOLID PHASE MICROEXTRACTION (SPME)	SOLID-PHASE MICROEXTRACTION (SPME)	(SPME)
SOLIDE PHASE MICROEXTRACTION	SOLID-PHASE MICROEXTRACTION (SPME)	(SPME)
SOLID-PHASE MICROEXTRACTION	SOLID PHASE MICRO-EXTRACTION (SPME)	(SPME)
SOLID-PHASE MICROEXTRACTION	SOLID-PHASE MICROEXTRACTION (SPME)	(SPME)
SOLID-PHASE MICRO-EXTRACTION	SOLID-PHASE MICROEXTRACTION (SPME)	(SPME)
SPECTROMETER	SPECTROMETRY	SPECTROMETRY
SPECTROMETERS	SPECTROMETRY	SPECTROMETRY
"SPECTROMETRY, FLUORESCENCE"	FLUORESCENCE SPECTROSCOPY	FLUORESCENCE SPECTROSCOPY
"SPECTROMETRY, MASS, SECONDARY ION"	SECONDARY ION MASS SPECTROMETRY (SIMS)	(SIMS)
"SPECTROMETRY, X-RAY EMISSION"	X-RAY EMISSION SPECTROMETRY	X-RAY EMISSION SPECTROMETRY
"SPECTROPHOTOMETRY, ATOMIC"	ATOMIC ABSORPTION SPECTROSCOPY (AAS)	(AAS)
"SPECTROPHOTOMETRY, ATOMIC ABSORPTION"	ATOMIC ABSORPTION SPECTROSCOPY (AAS)	(AAS)
"SPECTROPHOTOMETRY, ULTRAVIOLET"	ULTRAVIOLET SPECTROPHOTOMETRY	ULTRAVIOLET SPECTROPHOTOMETRY
"SPECTROSCOPY, ABSORPTION"	ABSORPTION SPECTROSCOPY	ABSORPTION SPECTROSCOPY
"SPECTROSCOPY, FOURIER TRANSFORM INFRARED"	FOURIER-TRANSFORM INFRARED SPECTROSCOPY (FT-IR)	(FT-IR)
"SPECTROSCOPY, FOURIER TRANSFORM INFRARED"	FOURIER-TRANSFORM INFRARED SPECTROSCOPY (FT-IR)	(FT-IR)
"SPECTROSCOPY, X-RAY"	X-RAY SPECTROSCOPY	X-RAY SPECTROSCOPY
"SPECTRUM ANALYSIS, RAMAN"	RAMAN	RAMAN
SPENT CARTRIDGES	SPENT CARTRIDGE	SPENT CARTRIDGE
SPME	SOLID PHASE MICRO-EXTRACTION (SPME)	(SPME)
SPME	SOLID-PHASE MICROEXTRACTION (SPME)	(SPME)
SPORTS	SPORT	SPORT
STARTER?ÇÖS PISTOL	STARTER PISTOL	STARTER PISTOL
STEREOMICROSCOPY	STEREO MICROSCOPE	STEREO MICROSCOPE
STUBS	STUB	STUB
SUB MICRON	SUB-MICRON	SUB-MICRON
SUICIDES	SUICIDE	SUICIDE
SUPPORT VECTOR MACHINES	SUPPORT VECTOR MACHINE	SUPPORT VECTOR MACHINE
SURFACE ENHANCED RAMAN SPECTROSCOPY	RAMAN	RAMAN
SURFACE PROPERTIES	SURFACE PROPERTY	SURFACE PROPERTY
SURFACE-ENHANCED RAMAN SPECTROSCOPY	RAMAN	RAMAN
SWABS	SWAB	SWAB
SWEAT GLANDS	SWEAT GLAND	SWEAT GLAND
SYNCHROTRONS	SYNCHROTRON	SYNCHROTRON
SYNTHETIC FIBER	SYNTHETIC FIBRE	SYNTHETIC FIBRE
SYNTHETIC FIBERS	SYNTHETIC FIBRE	SYNTHETIC FIBRE
TAPE LIFT KIT	TAPE LIFT	TAPE LIFT
TAPE-LIFT	TAPE LIFT	TAPE LIFT
TAPINGS	TAPING	TAPING
TARGET FIBER STUDIES	TARGET FIBRE STUDY	TARGET FIBRE STUDY
TARGET FIBRE STUDIES	TARGET FIBRE STUDY	TARGET FIBRE STUDY
TATTOO	TATTOOING	TATTOOING
TEXTILE DYE	DYE	DYE
TEXTILE DYES	DYE	DYE
TEXTILE FIBER	TEXTILE FIBRE	TEXTILE FIBRE
TEXTILE FIBERS	TEXTILE FIBRE	TEXTILE FIBRE
TEXTILES	TEXTILE	TEXTILE
"TEXTILVER?ñNDERUNGEN, PULVERGASE"	"TEXTILVER NDERUNGEN, PULVERGASE"	"TEXTILVER NDERUNGEN, PULVERGASE"
THIN FILMS	THIN FILM	THIN FILM
THIN LAYER	THIN-LAYER CHROMATOGRAPHY (TLC)	THIN-LAYER CHROMATOGRAPHY (TLC)
THIN LAYER CHROMATOGRAPHY	THIN LAYER CHROMATOGRAPHY (TLC)	THIN LAYER CHROMATOGRAPHY (TLC)
THIN LAYER CHROMATOGRAPHY	THIN-LAYER CHROMATOGRAPHY (TLC)	THIN-LAYER CHROMATOGRAPHY (TLC)
THIN-LAYER	THIN-LAYER CHROMATOGRAPHY (TLC)	THIN-LAYER CHROMATOGRAPHY (TLC)
THIN-LAYER CHROMATOGRAPHY	THIN-LAYER CHROMATOGRAPHY (TLC)	THIN-LAYER CHROMATOGRAPHY (TLC)
TIME FACTOR	TIME FACTORS	TIME FACTORS
TIME OF FLIGHT	TIME OF FLIGHT (TOF)	TIME OF FLIGHT (TOF)
TIME OF FLIGHT MASS SPECTROMETRY	TIME-OF-FLIGHT SECONDARY ION MASS SPECTROMETRY (TOF-SIMS)	(TOF-SIMS)
TIME OF FLIGHT SECONDARY ION MASS SPECTROMETRY	TIME-OF-FLIGHT SECONDARY ION MASS SPECTROMETRY (TOF-SIMS)	(TOF-SIMS)
TIME-OF-FLIGHT SECONDARY ION MASS SPECTROMETRY	TIME-OF-FLIGHT SECONDARY ION MASS SPECTROMETRY (TOF-SIMS)	(TOF-SIMS)
TISSUES	TISSUE	TISSUE
TLC	THIN-LAYER CHROMATOGRAPHY (TLC)	THIN-LAYER CHROMATOGRAPHY (TLC)
TOF SIMS	TIME-OF-FLIGHT SECONDARY ION MASS SPECTROMETRY (TOF-SIMS)	(TOF-SIMS)
TOF-SIMS	TIME-OF-FLIGHT SECONDARY ION MASS SPECTROMETRY (TOF-SIMS)	(TOF-SIMS)
TOOTH FRACTURES	TOOTH FRACTURE	TOOTH FRACTURE
TRACE ELEMENT	TRACE EVIDENCE	TRACE EVIDENCE
TRACE ELEMENTS	TRACE EVIDENCE	TRACE EVIDENCE
TRACE EVIDENCE ANALYSIS	TRACE EVIDENCE	TRACE EVIDENCE
TRACE EVIDENCES	TRACE EVIDENCE	TRACE EVIDENCE
TRANSITION-EDGE SENSORS	TRANSITION-EDGE SENSOR	TRANSITION-EDGE SENSOR
TRICARBOXYLIC ACIDS	TRICARBOXYLIC ACID	TRICARBOXYLIC ACID
TRIPHENYLMETHANES	TRIPHENYLMETHANE	TRIPHENYLMETHANE
ULTRA-HIGH PERFORMANCE LIQUID CHROMATOGRAPHIES	ULTRA-HIGH PERFORMANCE LIQUID CHROMATOGRAPHY (UHPLC)	(UHPLC)
ULTRAVIOLET SPECTROPHOTOMETRY	ULTRAVIOLET SPECTROSCOPY	ULTRAVIOLET SPECTROSCOPY
UPLC?ÇôMS/MS	UPLC-MS/MS	UPLC-MS/MS
UV-VIS MICROSPECTROPHOTOMETRY	MICROSPECTROPHOTOMETRY (MSP)	MICROSPECTROPHOTOMETRY (MSP)
UV-VISIBLE SPECTROPHOTOMETRY	SPECTROPHOTOMETRY	SPECTROPHOTOMETRY
UV-VISIBLE SPECTROSCOPY	SPECTROPHOTOMETRY	SPECTROPHOTOMETRY
VISCOSE FIBER	VISCOSE	VISCOSE
VOLATILE ORGANIC COMPOUNDS	VOLATILE ORGANIC COMPOUND	VOLATILE ORGANIC COMPOUND
WOOL FIBRES	WOOL	WOOL
WOUNDS	WOUND	WOUND
"WOUNDS, GUNSHOT"	GUNSHOT WOUND	GUNSHOT WOUND
"WOUNDS, STAB"	STAB WOUND	STAB WOUND
X RAY	X-RAY	X-RAY
X- RAY	X-RAY	X-RAY
X RAY ABSORPTION	X-RAY ABSORPTION	X-RAY ABSORPTION
X RAY ANALYSIS	X-RAY ANALYSIS	X-RAY ANALYSIS
X RAY BEAM	X-RAY BEAM	X-RAY BEAM
X RAY DIFFRACTION	X-RAY DIFFRACTION	X-RAY DIFFRACTION
X RAY DOSE DISTRIBUTION	X-RAY DOSE DISTRIBUTION	X-RAY DOSE DISTRIBUTION
X RAY ENERGY DISPERSIVE SPECTROMETRY	ENERGY DISPERSIVE SPECTROSCOPY (EDS)	(EDS)
X RAY FLUORESCENCE	X-RAY FLUORESCENCE	X-RAY FLUORESCENCE
X RAY FLUORESCENCE ANALYSIS	X-RAY FLUORESCENCE ANALYSIS (XRF)	X-RAY FLUORESCENCE ANALYSIS (XRF)
X RAY FLUORESCENCE SPECTROMETRY	X-RAY FLUORESCENCE ANALYSIS (XRF)	X-RAY FLUORESCENCE ANALYSIS (XRF)
X RAY MICROANALYSIS	X-RAY MICROANALYSIS	X-RAY MICROANALYSIS
X RAY MICRODIFFRACTION	X-RAY MICRODIFFRACTION	X-RAY MICRODIFFRACTION
X RAY PHOTOELECTRON SPECTROSCOPY	X-RAY PHOTOELECTRON SPECTROSCOPY (XPS)	(XPS)
X RAY SPECTROMETRY	X-RAY SPECTROMETRY	X-RAY SPECTROMETRY
X RAY SPECTROSCOPY	X-RAY SPECTROSCOPY	X-RAY SPECTROSCOPY
X RAYS	X-RAY	X-RAY
XPS	X-RAY PHOTOELECTRON SPECTROSCOPY (XPS)	(XPS)
X-RAY EMISSION SPECTROMETRY	X-RAY EMISSION SPECTROMETRY (XES)	X-RAY EMISSION SPECTROMETRY (XES)
X-RAY ENERGY DISPERSIVE SPECTROSCOPY	ENERGY DISPERSIVE SPECTROSCOPY (EDS)	(EDS)
X-RAY FLUORESCENCE	X-RAY FLUORESCENCE ANALYSIS (XRF)	X-RAY FLUORESCENCE ANALYSIS (XRF)
X-RAY FLUORESCENCE (XRF)	X-RAY FLUORESCENCE ANALYSIS (XRF)	X-RAY FLUORESCENCE ANALYSIS (XRF)
XRAY FLUORESCENCE ANALYSIS	X-RAY FLUORESCENCE ANALYSIS (XRF)	X-RAY FLUORESCENCE ANALYSIS (XRF)
X-RAY FLUORESCENCE ANALYSIS	X-RAY FLUORESCENCE ANALYSIS (XRF)	X-RAY FLUORESCENCE ANALYSIS (XRF)
X-RAY GENERATORS	X-RAY GENERATOR	X-RAY GENERATOR
X-RAY MICROFLUORESCENCE	X-RAY MICROFLUORESCENCE SPECTROMETRY (MICRO-XRF)	(MICRO-XRF)
XRF	X-RAY FLUORESCENCE ANALYSIS (XRF)	X-RAY FLUORESCENCE ANALYSIS (XRF)
Z SCORES	Z-SCORES	Z-SCORES
ZINC	ZINC (ZN)	ZINC (ZN)
	NA	NA
